.....#......#.#.......
.......#.#......#.##..
..#.#......##.#.......
..#..#..#.##.....#.#..
........#.........#.#.
#...#....##.##.##.....
...#.#.#....#..#....#.
#.#...#..#....#..#....
....#.....##....#.#...
#....#.......##......#
......#......##..#.#..
.#.......#.#....#.#...
