3 3 3 3 3 3 3 3 3 3 3 3 3 3 3 3 3 3 3 3 3 13 8 8 8 8 18 3 3 3 3 3 3 3 3 3 3 3 4 4 3 3 3 3 7 7 3 2 2 2 3 3 3 3 13 17 13 17 13 17 
4 4 4 4 4 3 3 3 23 23 23 3 3 3 2 2 2 3 3 3 3 8 8 8 8 8 3 3 3 3 3 3 3 4 4 4 4 4 4 4 3 3 7 7 7 3 3 2 2 2 3 3 3 13 8 8 8 8 8 18 
4 4 4 4 4 4 3 3 23 3 3 3 1 3 3 2 2 3 3 3 13 8 8 8 8 8 17 3 3 3 3 3 3 4 4 4 4 4 4 4 3 3 3 3 3 3 3 3 3 2 3 3 3 15 8 8 8 8 8 17 
4 7 7 4 4 3 3 3 3 3 3 3 3 3 3 3 3 3 3 3 8 8 8 8 8 8 18 3 3 3 3 3 3 4 4 4 4 4 4 4 3 3 3 3 3 5 3 3 3 3 3 3 3 13 8 8 8 18 15 18 
7 7 7 3 3 3 3 3 3 3 3 3 3 3 3 3 3 3 3 3 15 8 8 8 8 18 3 3 3 3 3 3 3 4 4 4 3 3 3 3 3 3 3 5 5 5 3 3 3 3 3 3 3 15 8 8 8 17 3 3 
3 3 3 3 3 3 3 3 22 9 20 3 3 3 3 3 5 5 5 3 3 3 3 3 3 3 3 3 3 3 3 3 3 3 3 3 3 3 3 3 3 3 3 5 5 5 3 3 3 3 3 3 3 13 8 18 15 18 3 23 
3 3 3 3 3 3 22 9 9 9 9 3 3 3 3 3 5 5 5 3 3 3 3 3 3 3 3 3 3 3 3 3 3 3 3 3 3 3 3 3 3 3 3 3 3 3 3 3 3 3 3 3 3 15 18 3 3 23 23 23 
3 3 3 3 3 3 19 9 9 9 21 3 3 3 3 3 5 5 5 3 3 3 3 3 3 3 1 3 3 3 3 3 3 3 3 3 3 22 20 3 3 3 3 3 3 3 3 3 3 3 3 3 3 3 3 3 3 23 23 23 
3 3 3 3 3 3 3 19 9 9 20 3 3 24 3 3 5 5 5 3 3 3 3 22 9 20 3 3 3 3 3 3 3 3 3 22 9 9 9 3 3 3 3 3 3 3 3 3 3 3 3 3 3 3 3 3 3 3 3 3 
3 3 3 1 3 3 3 3 3 19 21 3 3 3 3 3 5 3 3 3 3 3 3 9 9 21 3 3 3 3 3 12 13 12 13 19 9 9 21 3 3 3 3 3 3 3 3 3 3 3 3 3 3 3 3 3 3 3 3 3 
3 3 3 3 3 3 3 3 3 3 3 3 3 3 3 3 3 3 7 3 3 3 3 19 21 3 3 12 13 12 10 10 10 10 10 13 3 3 3 3 3 3 3 3 3 3 3 3 3 22 9 9 20 3 3 4 4 4 4 4 
3 3 3 3 3 3 3 3 3 3 3 3 3 3 3 3 3 3 7 7 3 3 3 3 3 3 12 10 10 10 10 10 10 10 10 14 3 3 3 3 3 3 3 3 3 3 3 3 3 9 9 9 21 3 3 4 4 4 4 4 
13 17 13 17 13 17 3 3 3 3 3 3 3 3 3 3 3 3 7 7 7 7 7 12 13 12 10 10 10 10 10 10 10 10 10 13 12 13 3 3 3 3 3 3 3 3 3 3 3 19 21 3 3 3 3 4 4 4 4 4 
8 8 8 8 8 8 17 3 3 3 3 3 3 3 3 3 3 3 3 3 3 3 3 11 10 10 10 10 10 10 10 10 10 10 10 10 10 10 10 13 3 3 3 4 4 4 4 4 3 3 3 3 3 3 3 4 4 4 4 4 
8 8 8 8 8 8 18 3 3 3 3 3 3 3 3 3 3 3 3 3 3 3 3 12 10 10 10 10 10 10 10 10 10 10 10 10 10 10 10 14 3 3 3 4 4 4 4 3 3 3 3 3 3 3 4 4 4 4 4 4 
8 8 8 8 8 18 3 3 3 3 25 3 3 3 4 4 4 4 4 4 3 3 12 10 10 10 10 10 10 10 10 10 10 10 10 10 10 10 10 13 12 13 3 4 4 4 3 3 3 3 3 3 3 3 4 4 3 3 7 3 
8 8 8 8 18 3 3 3 3 3 3 3 3 3 4 4 4 4 4 4 3 3 11 10 10 10 10 10 10 10 10 10 10 10 10 10 10 10 10 10 10 14 3 4 4 4 3 3 3 3 3 3 3 3 3 3 3 3 7 3 
8 8 8 8 17 3 3 3 3 3 3 3 3 3 4 4 4 4 3 3 12 13 12 10 10 10 10 10 10 10 10 10 10 10 10 10 10 10 10 10 10 13 12 13 3 3 3 3 3 3 3 3 3 3 3 3 3 3 7 7 
8 8 8 8 18 3 3 3 3 3 3 3 3 3 4 4 4 4 3 12 10 10 10 10 10 10 10 10 10 10 10 10 10 10 10 10 10 10 10 10 10 10 10 14 3 3 3 3 3 3 3 3 3 3 3 3 3 3 3 3 
8 8 8 18 3 3 3 3 3 3 3 3 3 3 4 4 4 4 3 11 10 10 10 10 10 10 10 10 10 10 10 10 10 10 10 10 10 10 10 10 10 10 10 3 3 3 3 3 3 3 3 3 3 3 3 3 3 3 3 3 
4 4 4 4 4 3 3 3 3 3 3 3 3 3 3 3 3 12 10 10 10 10 10 10 10 10 10 10 10 10 10 10 10 10 10 10 10 10 10 10 10 10 14 3 3 3 3 3 3 3 3 3 3 4 4 4 4 4 4 4 
4 4 4 4 4 3 3 3 3 3 23 3 3 3 3 3 3 11 10 10 10 10 10 10 10 10 10 10 10 10 10 10 10 10 10 10 10 10 10 10 10 14 3 3 3 3 3 2 2 2 3 3 3 4 4 4 4 5 5 5 
4 4 4 4 4 3 3 3 23 23 23 3 3 3 3 3 3 3 11 14 11 10 10 10 10 10 10 10 10 10 10 10 10 10 10 10 10 10 10 10 10 12 3 3 3 3 3 2 2 3 3 3 3 4 4 4 4 5 5 3 
4 4 4 5 5 5 3 3 23 23 3 3 3 3 3 22 20 3 3 3 12 10 10 10 10 10 10 10 10 10 10 10 10 10 10 10 10 10 10 10 10 14 3 3 3 3 3 3 3 3 3 3 3 4 4 4 4 5 5 3 
3 3 3 5 5 5 3 3 3 3 3 3 3 3 22 9 9 9 3 3 11 10 10 10 10 10 10 10 10 10 10 10 10 10 10 10 10 10 10 10 14 3 3 3 3 3 3 3 3 3 3 3 3 3 4 4 3 3 3 3 
3 3 3 3 3 3 3 3 3 3 3 3 3 3 19 9 9 21 3 3 3 11 10 10 10 10 10 10 10 10 10 10 10 10 10 10 10 10 10 10 13 3 3 3 3 3 3 3 3 3 3 3 3 3 3 3 3 3 3 3 
3 3 3 3 3 3 3 3 3 3 3 3 3 3 3 3 3 3 3 3 3 12 10 10 10 10 10 10 10 10 10 10 10 10 10 10 10 10 10 10 14 3 3 3 13 17 13 17 3 3 3 3 3 3 3 3 3 3 3 3 
3 3 3 3 3 3 3 22 20 22 20 3 3 3 3 3 3 3 3 3 3 11 10 10 10 10 10 10 10 10 10 10 10 10 10 10 10 10 10 14 3 3 3 13 8 8 8 8 3 3 3 3 3 3 3 3 3 3 3 3 
3 3 3 3 3 3 3 9 9 9 9 20 3 3 3 3 3 3 3 3 3 3 11 14 11 10 10 10 10 10 10 10 10 10 10 10 10 10 10 12 3 3 3 15 8 8 8 8 17 3 3 3 3 3 3 3 3 3 3 3 
13 17 3 3 3 3 3 19 9 9 9 9 3 3 3 3 3 3 3 3 3 7 3 3 12 10 10 10 10 10 10 10 10 10 10 10 10 10 10 14 3 3 3 13 8 8 8 8 18 3 3 3 3 3 3 3 3 3 3 3 
8 8 17 13 17 3 3 3 9 9 9 21 3 3 3 3 3 3 3 7 7 7 3 3 11 10 10 10 10 10 10 10 10 10 10 10 10 14 3 3 3 3 3 15 8 8 18 3 3 3 3 3 3 3 3 22 20 3 3 3 
8 8 8 8 18 3 3 3 3 19 21 3 3 3 3 3 3 3 3 3 3 3 3 3 3 11 10 10 10 10 10 10 10 10 10 14 3 3 3 3 3 3 3 3 3 3 3 3 3 3 3 3 3 3 22 9 9 20 3 3 
8 8 8 8 17 3 3 3 3 3 3 3 3 3 3 3 3 3 3 13 17 3 3 3 3 3 11 10 10 10 10 10 10 10 10 3 3 3 3 3 3 3 3 3 3 3 3 3 3 3 3 3 3 3 19 9 9 21 3 3 
8 8 8 8 8 17 3 3 3 3 3 3 3 3 3 3 3 13 8 8 8 17 3 3 3 3 3 11 10 10 10 10 10 10 14 3 3 7 7 7 3 3 22 20 22 9 3 3 3 3 3 3 3 3 3 19 21 3 3 3 
8 8 8 8 8 18 3 3 3 3 3 3 3 3 3 3 3 15 8 8 8 18 3 3 3 3 3 12 10 10 10 10 14 3 3 3 3 7 7 3 22 9 9 9 9 21 3 3 3 3 3 3 3 3 3 3 3 3 13 17 
8 8 8 8 18 3 3 3 3 3 4 4 4 4 4 3 3 3 3 15 18 3 3 3 3 3 3 11 10 10 14 3 3 3 3 3 3 3 3 3 19 9 9 9 21 3 3 3 3 3 3 3 3 3 3 3 3 13 8 8 
15 18 15 18 3 3 3 3 3 3 4 4 4 4 4 3 3 3 3 3 3 3 3 3 3 3 3 3 11 14 3 3 3 3 3 3 3 4 4 4 3 3 19 21 3 3 3 3 3 3 3 3 3 3 3 13 8 8 8 8 
3 3 3 3 3 3 3 3 3 3 4 4 4 4 4 3 3 3 3 3 3 3 2 2 3 3 3 3 3 3 3 3 3 3 3 4 4 4 4 4 3 3 3 3 3 3 3 3 23 23 23 3 3 3 13 8 8 8 8 8 
3 3 3 3 3 3 3 3 3 3 3 4 4 4 4 4 4 3 3 3 3 3 2 2 3 3 3 3 3 3 3 3 3 3 3 4 4 4 4 4 4 4 4 4 4 3 3 3 23 23 3 3 3 3 15 8 8 8 8 8 
3 3 3 3 3 3 3 3 3 3 3 4 4 4 4 4 4 3 3 3 3 3 3 3 3 3 3 3 3 3 3 3 3 3 3 4 4 4 4 4 4 4 4 4 4 3 3 3 3 3 3 3 3 3 13 8 8 8 8 8 
