6 6 6 6 6 6 6 6 6 6 6 6 6 6 6 6 6 6 6 6 6 16 8 8 8 8 18 6 6 6 6 6 6 6 6 6 6 6 4 4 6 6 6 6 7 7 6 2 2 2 6 6 6 6 16 17 16 17 16 17 
4 4 4 4 4 6 6 6 23 23 23 6 6 6 2 2 2 6 6 6 6 8 8 8 8 8 6 6 6 6 6 6 6 4 4 4 4 4 4 4 6 6 7 7 7 6 6 2 2 2 6 6 6 16 8 8 8 8 8 18 
4 4 4 4 4 4 6 6 23 6 6 6 1 6 6 2 2 6 6 6 16 8 8 8 8 8 17 6 6 6 6 6 6 4 4 4 4 4 4 4 6 6 6 6 6 6 6 6 6 2 6 6 6 15 8 8 8 8 8 17 
4 7 7 4 4 6 6 6 6 6 6 6 6 6 6 6 6 6 6 6 8 8 8 8 8 8 18 6 6 6 6 6 6 4 4 4 4 4 4 4 6 6 6 6 6 5 6 6 6 6 6 6 6 16 8 8 8 18 15 18 
7 7 7 6 6 6 6 6 6 6 6 6 6 6 6 6 6 6 6 6 15 8 8 8 8 18 6 6 6 6 6 6 6 4 4 4 6 6 6 6 6 6 6 5 5 5 6 6 6 6 6 6 6 15 8 8 8 17 6 6 
6 6 6 6 6 6 6 6 22 9 20 6 6 6 6 6 5 5 5 6 6 6 6 6 6 6 6 6 6 6 6 6 6 6 6 6 6 6 6 6 6 6 6 5 5 5 6 6 6 6 3 3 6 16 8 18 15 18 6 23 
6 6 6 6 6 6 22 9 9 9 9 6 6 6 6 6 5 5 5 6 6 6 6 6 6 6 6 6 6 6 6 6 6 6 6 6 6 6 6 6 6 6 6 6 6 6 6 6 6 6 3 3 6 15 18 6 6 23 23 23 
6 3 3 3 6 6 19 9 9 9 21 6 6 6 6 6 5 5 5 6 6 6 6 6 6 6 1 6 6 6 6 6 6 6 6 6 6 22 20 6 6 6 6 6 6 6 6 6 6 6 6 6 6 6 6 6 6 23 23 23 
6 3 3 6 6 6 6 19 9 9 20 6 6 24 6 6 5 5 5 6 6 6 6 22 9 20 6 6 6 6 6 6 6 6 6 22 9 9 9 6 6 6 6 6 6 6 6 6 6 6 6 6 6 6 6 6 6 6 6 6 
6 6 6 1 6 6 6 6 6 19 21 6 6 6 6 6 5 6 6 6 6 6 6 9 9 21 6 6 6 6 6 12 13 12 13 19 9 9 21 6 6 6 6 6 6 6 6 6 6 6 6 6 6 6 6 6 6 6 6 6 
6 6 6 6 6 6 6 6 6 6 6 6 6 6 6 6 6 6 7 6 6 6 6 19 21 6 6 12 13 12 10 10 10 10 10 13 6 6 6 6 6 6 6 6 6 6 6 6 6 22 9 9 20 6 6 4 4 4 4 4 
6 6 6 6 6 6 6 6 6 6 6 6 6 6 6 6 6 6 7 7 6 6 6 6 6 6 12 10 10 10 10 10 10 10 10 14 6 6 6 6 6 6 6 6 6 6 6 6 6 9 9 9 21 6 6 4 4 4 4 4 
16 17 16 17 16 17 6 6 6 6 6 6 6 6 6 6 6 6 7 7 7 7 7 12 13 12 10 10 10 10 10 10 10 10 10 13 12 13 6 6 6 6 6 6 6 6 6 6 6 19 21 6 6 6 6 4 4 4 4 4 
8 8 8 8 8 8 17 6 6 6 6 6 6 6 6 6 6 6 6 6 6 6 6 11 10 10 10 10 10 10 10 10 10 10 10 10 10 10 10 13 6 6 6 4 4 4 4 4 6 6 6 6 6 6 6 4 4 4 4 4 
8 8 8 8 8 8 18 6 6 6 6 6 6 6 6 6 6 6 6 6 6 6 6 12 10 10 10 10 10 10 10 10 10 10 10 10 10 10 10 14 6 6 6 4 4 4 4 6 6 6 6 6 6 6 4 4 4 4 4 4 
8 8 8 8 8 18 6 6 6 6 25 6 6 6 4 4 4 4 4 4 6 6 12 10 10 10 10 10 10 10 10 10 10 10 10 10 10 10 10 13 12 13 6 4 4 4 6 6 6 6 6 6 6 6 4 4 6 6 7 6 
8 8 8 8 18 6 6 6 6 6 6 6 6 6 4 4 4 4 4 4 6 6 11 10 10 10 10 10 10 10 10 10 10 10 10 10 10 10 10 10 10 14 6 4 4 4 6 6 3 3 3 6 6 6 6 6 6 6 7 6 
8 8 8 8 17 6 6 6 6 6 6 6 6 6 4 4 4 4 6 6 12 13 12 10 10 10 10 10 10 10 10 10 10 10 10 10 10 10 10 10 10 13 12 13 6 6 6 6 3 3 3 3 6 6 6 6 6 6 7 7 
8 8 8 8 18 6 6 6 6 6 6 6 6 6 4 4 4 4 6 12 10 10 10 10 10 10 10 10 10 10 10 10 10 10 10 10 10 10 10 10 10 10 10 14 6 6 6 6 6 6 6 6 6 6 6 6 6 6 6 6 
8 8 8 18 6 6 6 6 6 6 6 6 6 6 4 4 4 4 6 11 10 10 10 10 10 10 10 10 10 10 10 10 10 10 10 10 10 10 10 10 10 10 10 6 6 6 6 6 6 6 6 6 6 6 6 6 6 6 6 6 
4 4 4 4 4 6 6 6 6 6 6 6 6 6 6 6 6 12 10 10 10 10 10 10 10 10 10 10 10 10 10 10 10 10 10 10 10 10 10 10 10 10 14 6 6 6 6 6 6 6 6 6 6 4 4 4 4 4 4 4 
4 4 4 4 4 6 6 6 6 6 23 6 6 6 6 6 6 11 10 10 10 10 10 10 10 10 10 10 10 10 10 10 10 10 10 10 10 10 10 10 10 14 6 6 6 6 6 2 2 2 6 6 6 4 4 4 4 5 5 5 
4 4 4 4 4 6 6 6 23 23 23 6 6 6 6 6 6 6 11 14 11 10 10 10 10 10 10 10 10 10 10 10 10 10 10 10 10 10 10 10 10 12 6 6 6 6 6 2 2 6 6 6 6 4 4 4 4 5 5 6 
4 4 4 5 5 5 6 6 23 23 6 6 6 6 6 22 20 6 6 6 12 10 10 10 10 10 10 10 10 10 10 10 10 10 10 10 10 10 10 10 10 14 6 6 6 6 6 6 6 6 6 6 6 4 4 4 4 5 5 6 
6 6 6 5 5 5 6 6 6 6 6 6 6 6 22 9 9 9 6 6 11 10 10 10 10 10 10 10 10 10 10 10 10 10 10 10 10 10 10 10 14 6 6 6 6 6 6 6 6 6 6 6 6 6 4 4 6 6 6 6 
6 6 6 6 6 6 6 6 6 6 6 6 6 6 19 9 9 21 6 6 6 11 10 10 10 10 10 10 10 10 10 10 10 10 10 10 10 10 10 10 13 6 6 6 6 6 6 6 6 6 6 6 6 6 6 6 6 6 6 6 
6 6 6 6 6 6 6 6 6 6 6 6 6 6 6 6 6 6 6 6 6 12 10 10 10 10 10 10 10 10 10 10 10 10 10 10 10 10 10 10 14 6 6 6 16 17 16 17 6 6 6 6 6 6 6 6 3 3 3 6 
6 6 6 6 6 6 6 22 20 22 20 6 6 6 6 6 6 6 6 6 6 11 10 10 10 10 10 10 10 10 10 10 10 10 10 10 10 10 10 14 6 6 6 16 8 8 8 8 6 6 6 6 6 6 6 6 3 3 3 6 
6 6 6 6 6 6 6 9 9 9 9 20 6 6 6 6 6 6 6 6 6 6 11 14 11 10 10 10 10 10 10 10 10 10 10 10 10 10 10 12 6 6 6 15 8 8 8 8 17 6 6 6 6 6 6 6 6 6 6 6 
16 17 6 6 6 6 6 19 9 9 9 9 6 6 6 6 6 6 6 6 6 7 6 6 12 10 10 10 10 10 10 10 10 10 10 10 10 10 10 14 6 6 6 16 8 8 8 8 18 6 6 6 6 6 6 6 6 6 6 6 
8 8 17 16 17 6 6 6 9 9 9 21 6 6 6 6 6 6 6 7 7 7 6 6 11 10 10 10 10 10 10 10 10 10 10 10 10 14 6 6 6 6 6 15 8 8 18 6 6 6 6 6 6 6 6 22 20 6 6 6 
8 8 8 8 18 6 6 6 6 19 21 6 6 6 6 6 6 6 6 6 6 6 6 6 6 11 10 10 10 10 10 10 10 10 10 14 6 6 6 6 6 6 6 6 6 6 6 6 6 6 6 6 6 6 22 9 9 20 6 6 
8 8 8 8 17 6 6 6 6 6 6 6 6 6 6 6 6 6 6 16 17 6 6 6 6 6 11 10 10 10 10 10 10 10 10 6 6 6 6 6 6 6 6 6 6 6 6 6 6 6 6 6 6 6 19 9 9 21 6 6 
8 8 8 8 8 17 6 6 6 6 6 6 6 6 6 6 6 16 8 8 8 17 6 6 6 6 6 11 10 10 10 10 10 10 14 6 6 7 7 7 6 6 22 20 22 9 6 6 6 6 6 6 6 6 6 19 21 6 6 6 
8 8 8 8 8 18 6 6 6 6 6 6 6 6 6 6 6 15 8 8 8 18 6 6 6 6 6 12 10 10 10 10 14 6 6 6 6 7 7 6 22 9 9 9 9 21 6 6 6 6 6 6 6 6 6 6 6 6 16 17 
8 8 8 8 18 6 6 6 6 6 4 4 4 4 4 6 6 6 6 15 18 6 6 6 6 6 6 11 10 10 14 6 6 6 6 6 6 6 6 6 19 9 9 9 21 6 6 6 6 6 6 6 6 6 6 6 6 16 8 8 
15 18 15 18 6 6 6 6 6 6 4 4 4 4 4 6 6 6 6 6 6 6 6 6 6 6 6 6 11 14 6 6 6 6 6 6 6 4 4 4 6 6 19 21 6 6 6 6 6 6 6 6 6 6 6 16 8 8 8 8 
6 6 6 6 6 3 3 3 6 6 4 4 4 4 4 6 6 6 6 6 6 6 2 2 6 6 6 6 6 6 6 6 6 6 6 4 4 4 4 4 6 6 6 6 6 6 6 6 23 23 23 6 6 6 16 8 8 8 8 8 
6 6 6 6 6 3 3 6 6 6 6 4 4 4 4 4 4 6 6 6 6 6 2 2 6 6 6 6 6 6 6 6 6 6 6 4 4 4 4 4 4 4 4 4 4 6 6 6 23 23 6 6 6 6 15 8 8 8 8 8 
6 6 6 6 6 6 6 6 6 6 6 4 4 4 4 4 4 6 6 6 6 6 6 6 6 6 6 6 6 6 6 6 6 6 6 4 4 4 4 4 4 4 4 4 4 6 6 6 6 6 6 6 6 6 16 8 8 8 8 8 
