333333283328332833333333333333333333333333333333333333333335666533333333333
333333883388338833333333333333335533333333333333333333333356666653333333333
333333883388338833333333333333356653333333333333333333333566656665333333283
333333333333333333333333333333566665333333333333333333333566566665333333883
333333333333333333333333333335666665333333333333333333333355666653333333883
333283333333333333333333333356666653333333333333333333333356666533333283333
333883333328332833333333333566666533333333333333333333333566665333333883333
333883333388338833333333333566665333333333333333333333335666653333333883333
333333333388338833333333333356653333333333333333333333356666653333333332833
533333333333333333333333333335533333333333333333333333356666665333333338833
553333333333333333333333333333333333333333333333333333335666665333333338833
555333333333328333333333333333333333333333333333333333335666653333333333333
665333332833388328333333333113333333333333333333333333356666653333332833283
655333338833388388333333331411333333333333333333333333356666665333338833883
666533338833333388333333311441133333333333333333333333566666666533338833883
666653333333328333283333311411113333333333333333333333566566666533333328333
666553333333388333883333331111111333333333333333333333356666665333333388333
665533333283388333883333333111111333333333333333333333335666653333333388333
666533333883333283333333333311113333333333333333333333333566533333333333333
666653333883333883328333333331133333333333333333333333333355333332833333333
666665333333333883388333333333333333333333333333333333333333333338833333333
666666533333333333388333333333333333333333333333333333333333333338833333333
666666533333333333333333333333333333333311333333113333333333333333333333333
666666533333333333333333333333333333333111133331111333333333333333333333333
666666653333333333333333333333333333331411113311111133333333333333333333333
666666665333333333333333333333333333311444111111111133333333333333333333333
666666666653333333333333333333333333111141111111111333333333333333333333333
666666666665333333333333333333333333111111111111113333333333333333333333333
666666666666653333333333333333333333311111111111133333333333333333333333333
666666666666665333333333333333333333331111111441333333333283333333333333333
666666666666666533333333332833333333333114111113333332833883333333333333333
666666666666666533333333338833333333333311111133333338833883333333333333333
666666666666666653333333338833333333333331111333333338833333333333333333333
666666666666666653333333333333333333333333113333333333328328333333333333333
666666666666666653333333333333333333333333333333333333388388333333283283333
666666666666666653333333333332832833283333333333333333388388333333883883333
666666666666666533333333333338838833883328333333333333333283333333883883333
666666666666665333333333333338838833883388333333333333333883333333328333333
666666666666533333333333333333333333333388333333333333333883333333388333333
666666666665333333333332832833333333111333311111111133333333333333388333333
666666666665333333333338838833111111111333311111111111133333333333333333333
666666666653333333333338838811111111111111114411111111111133333333333333333
666666666533333333333333111111111111111111441111111333333333333333333333333
666666665333333333333311111111111111111111441111111111333333333333333333333
666666653333333333331111111111111111111111111111113333333333333333333333333
666666533333333333311111111111114444111111111111111333333333333333333333333
666665333333333333311111111111111141111111111133333333333333333333333333333
666533333333333333111111111111111111111111111133333333333311333333333333333
665333333333333311111111111111111111111111113333333333333111133333333333333
553333333333331111111111111111111111111111111333333333331111113333333333333
333333333111111111111111444111111111111111111133333333311111411333333333333
333333333111144411111111444111111111113333333333333333111144411333333333333
333331111111444411111111111111111111333333333333333331111141113333333333333
333111111111114411111111111111411111113333333333333331111111133333333333333
333333331111111111111111111114411111111333333333333333111111333333333333333
333311111111111111111111111114441111111333333333333333311113333333333333333
333333314411113333333311111111111111111111333333283283331133333333333333333
333333111111333333333333311111111133333333332833883883333333333333333333333
333333333333333333333333333111113333333333338833883883333333333333333333333
333333333333333333333333333311111333333333338833333333333333333333333333333